9999999999999999999999999999999999999999999999999999999999999999
9999999999999999999999999999999999999999999999999999999999999999
9999999999999999999999999999999999999999999999999999999999999999
9999999999999999999999999999999999999999999999999999999999999999
9999999999999999999999999999999999999999999999999999999999999999
9999999999999999999999999999999999999999999999999999999999999999
9999999999999999999999999999999999999999999999999999999999999999
9999999999999999999999999999999999999999999999999999999999999999
9999999999999999999999999999999999999999999999999999999999999999
9999999999999999999999999999999999999999999999999999999999999999
9999b22c9999999999999999b222c99999999999999999999999999999999999
9999100kc9999999999999991000399999999999999999999999999999999999
9999ai00kc99999999999999a444d99999999999999999999999999999999999
99999ai00kc99999999999999999999999999999999999999999999999999999
999999ai00k2c9999999999999b2c99999999999999999999999999999999999
9999999a4i00kc99999999999910kc9999999999999999999999999999999999
999999999ai00kc99999999999ai039999999999999999999999999999999999
9999999999ai0039999999999991039999b2c9999999b2c99999999999999999
99999999999ai0kc99999999999a4d999910kc99999910kc9999999999999999
999999999999100kc99999999999999999100kc99999ai0kc999999999999999
999999999999ai00399999999999999999a4i0kc99999ai03999999999999999
9999999999999a44d9999999999999999b2cai03999999a4d999999999999999
9999999999999999999999b2c999999991039a4d999999999999999999999999
999999999999999999999910399999999a4d9999999999999999999999999999
9999999999999999999999a4d999999999999999999999999999999999999999
9999999999999999999999999999999999999999999999999999999999999999
9999999999999999999999999999999999999999999999999999999999999999
999999999999b2c9999999999999999999999999999999999999999999999999
99999999999910kc9999999999999999b2222c99999999999999999999999999
9999999999991003999999999999999910000399999999999999999999999999
999999999999ai039999999999999999a44i0kc9999999999b2c999999999999
99999999999991039999999999999999999ai03999999999910kc99999999999
999999999999910399999999999999999999103999b2c9999ai0k2c999999999
9999999999999a4d9999999999999999999910399910399999ai003999999999
999999999999999999999b22c99999999999a4d999103999999a44d999999999
999999999999999999999100kc9999999999999999a4d9999b2c999999999999
999999999999999999999ai00399999999999999999999999103999999999999
9999999999999999999999ai039999999999999999999999910kc99999999999
9999999999999999999999910kc9999999999999999999999ai0kc9999999999
99999999999999999999999ai0399999999999999999999999ai0kc999999999
999999999999999999999999a4d999999999999999999999999ai03999999999
9999999999999b2c999999999999999999999999999999999999a4d999999999
9999999999999103999999999b2c999999999999999999999999999999999999
9999999999999a4d999b2c9991039b2c99999999999999999999999999999999
9999999999999999999103999a4d910kc9999999999999999999999999999999
9999999999999999999a4d9999999ai0kc999999999999999999999999999999
999999999999999999999999999999ai039999999b2c999999b2c99999999999
9999999999999999999999999999999a4d9999b2c10399999910399999999999
99999999999999999999999999999999999999103a4d999999a4d99999999999
999999999999999999999999999999b2c99999a4d99999999999999999999999
99999999999999999999999999999910kc999999999999999999999999999999
999999999999999999999999999999100kc99999999999b2c999999999999999
999999999999999999999999999b2cai00399999999999103999999999999999
9999999999999999999999999991039a44d99999999999a4d999999999999999
999999999999999999999999999a4d9999999999999999999999999999999999
9999999999999999999999999999999999999999999999999999999999999999
9999999999999999999999999999999999999999999999999999999999999999
9999999999999999999999999999999999999999999999999999999999999999
9999999999999999999999999999999999999999999999999999999999999999
9999999999999999999999999999999999999999999999999999999999999999
9999999999999999999999999999999999999999999999999999999999999999
9999999999999999999999999999999999999999999999999999999999999999
9999999999999999999999999999999999999999999999999999999999999999
9999999999999999999999999999999999999999999999999999999999999999