9999999999999999999999999999999999999999999999999999999999999999
9999999999999999999999999999999999999999999999999999999999999999
9999999999999999999999999999999999999999999999999999999999999999
9999999999999999999999999999999999999999999999999999999999999999
9999999999999999999999999999999999999999b2c999999999999999999999
9999999999999999999999999999999999999999103999999999999999999999
9999999999999999999999999999999999999999103999999999999999999999
9999999999999999999999999999999999999999a4d999999999999999999999
9999999999999999999999999999999999999999999999999999999999999999
9999999999999999999999999999999999999999999999999999999999999999
999999999999999999999b2c9999999999999999999999b22c99999999999999
99999999999999999999910kc99999999999999999999bj00399999b2c999999
999999999999999999999ai039999999999999999b2c910l4d9999bj03999999
9999999999999999999999a4d999999999999999bj0kca4d9999991003999999
9999999999999999999999999999999999999999100039999999991003999999
9999999999999999999999999999999999999999ai0ldb2c999999a44d999999
99999999999999999999999999999999999999999a4d910kc999999999999999
999999999999999999999999999999999999999999999ai03999999999999999
9999999999999999999999999999999999999999999999a4d999999999999999
9999999999999999999999999999999999999999999999999999999999999999
9999999999999999999999999999999999999999999999999999999999999999
9999999999999999999999999999999999999999b22c99999999999999999999
9999999999999999999999999999999999999999100399999999999999999999
9999999999999999999999999999999999999999ai039999999b22c999999999
99999999b2c999999999999999999999999999999a4d9999999100kc99999999
999999991039999999999999999999999999999999999999999ai00399999999
9999999910399999999999999999999999999999999999999999ai0399999999
99999999a4d999999999999999999999999999999999999999999a4d99999999
9999999999999999999999999999999999999999999999999999999999999999
9999999999999999b22c999999999999999999999999b2c99999999999999999
9999999999999999100399999999999999999999999910kc9999999999999999
999999999999999910ld99999999999999999999999bj0039999b22c99999999
999999999999999910399999999999999999999999910l4d9999100399999999
9999999999999999a4d999999999999999999999999a4d999999ai0kc9999999
99999999999999999999999999999999999999999999999999999ai039999999
999999999999999999999999999999999999999999999999999999a4d9999999
99999999999999999999999999999999999999b222c999999999999999999999
9999999999999999999999999999999999999910003999999999999999999999
9999999b22c999999999999999999999999999ai0ld999999999999999999999
9999999100k2c99999999999999999999999999a4d9999999999999999999999
9999999a4i003999999999999999999999999999999999999999999999999999
999999999a44d999999999999999999999999999999999999999999999999999
9999999999999999999999999999999999999999999999999999999999999999
9999999999999999999999b22c99999999999999999999999999999999999999
999999999999999999999bj00399999999999999999999b2c999999999999999
99999999999999999999910l4d9999999999999999999bj03999999999999999
999999999999999999999a4d99999999999999999999910ld999999999999999
99999999999999999999999999b2c9999999999999b2ca4d99999999b22c9999
99999999999999999999999b22j0kc99999999999910kc99b2c9999910039999
999999999999999999999991000003999999999999ai03b2j0399999ai039999
999999999999999999999991000l4d9999999999999a4d100ld99999910kc999
99999999999999999999999a444d999999999999999999ai039999999ai03999
99999999999999999b2c999999999999999999999999999a4d99999999a4d999
9999999999999999910kc9999999999999999999999999999999999999999999
9999999999999999910039999999999999999999999999999999999999999999
99999999999999999100kc99999999999b22c999999999999999999999999999
99999999999999999ai00kc99999999991003999999999999999999999999999
999999999999999999ai0039999999999a44d999999999999999999999999999
9999b2c99999999999910ld99999999999999999999999999999999999999999
999910kc99999999999a4d999999999999999999999999999999999999999999
9999100399999999999999999999999999999999999999999999999999999999
999910ld99999999999999999999999999999999999999999999999999999999
9999949999999999999999999999999999999999999999999999999999999999
9999999999999999999999999999999999999999999999999999999999999999
